English (en): eng
Cebuano (ceb): ceb
Deutsch (de): deu
français (fr): fra
svenska (sv): swe
Nederlands (nl): nld
русский (ru): rus
español (es): spa
italiano (it): ita
polski (pl): pol
مصرى (arz): arz
中文 (zh): zho
日本語 (ja): jpn
українська (uk): ukr
Tiếng Việt (vi): vie
Winaray (war): war
العربية (ar): ara
português (pt): por
فارسی (fa): fas
català (ca): cat
Bahasa Indonesia (id): ind
српски / srpski (sr): srp
한국어 (ko): kor
norsk (no): nor
Türkçe (tr): tur
нохчийн (ce): che
suomi (fi): fin
čeština (cs): ces
magyar (hu): hun
татарча / tatarça (tt): tat
română (ro): ron
srpskohrvatski / српскохрватски (sh): hbs
euskara (eu): eus
閩南語 / Bân-lâm-gú (zh-min-nan): Unknown
Bahasa Melayu (ms): msa
עברית (he): heb
Esperanto (eo): epo
հայերեն (hy): hye
dansk (da): dan
български (bg): bul
oʻzbekcha / ўзбекча (uz): uzb
Cymraeg (cy): cym
Simple English (simple): Unknown
slovenčina (sk): slk
eesti (et): est
беларуская (be): bel
تۆرکجه (azb): azb
Ελληνικά (el): ell
қазақша (kk): kaz
Minangkabau (min): min
hrvatski (hr): hrv
lietuvių (lt): lit
galego (gl): glg
اردو (ur): urd
azərbaycanca (az): aze
slovenščina (sl): slv
Ladin (lld): lld
ქართული (ka): kat
norsk nynorsk (nn): nno
தமிழ் (ta): tam
ไทย (th): tha
हिन्दी (hi): hin
বাংলা (bn): ben
македонски (mk): mkd
粵語 (zh-yue): Unknown
Latina (la): lat
asturianu (ast): ast
latviešu (lv): lav
Afrikaans (af): afr
тоҷикӣ (tg): tgk
မြန်မာဘာသာ (my): mya
తెలుగు (te): tel
shqip (sq): sqi
मराठी (mr): mar
Malagasy (mg): mlg
bosanski (bs): bos
occitan (oc): oci
беларуская (тарашкевіца) (be-tarask): Unknown
brezhoneg (br): bre
മലയാളം (ml): mal
Kiswahili (sw): swa
Plattdüütsch (nds): nds
kurdî (ku): kur
кыргызча (ky): kir
lombard (lmo): lmo
Jawa (jv): jav
پنجابی (pnb): pnb
کوردی (ckb): ckb
नेपाल भाषा (new): new
Kreyòl ayisyen (ht): hat
vèneto (vec): vec
Piemontèis (pms): pms
Lëtzebuergesch (lb): ltz
башҡортса (ba): bak
Sunda (su): sun
Gaeilge (ga): gle
íslenska (is): isl
ślůnski (szl): szl
чӑвашла (cv): chv
ਪੰਜਾਬੀ (pa): pan
Frysk (fy): fry
Ido (io): ido
Hausa (ha): hau
Tagalog (tl): tgl
aragonés (an): arg
مازِرونی (mzn): mzn
吴语 (wuu): wuu
Zazaki (diq): diq
Volapük (vo): vol
Igbo (ig): ibo
Yorùbá (yo): yor
Scots (sco): sco
ಕನ್ನಡ (kn): kan
नेपाली (ne): nep
Alemannisch (als): als
ગુજરાતી (gu): guj
interlingua (ia): ina
Kotava (avk): avk
qırımtatarca (crh): crh
Boarisch (bar): bar
sicilianu (scn): scn
Basa Bali (ban): ban
বিষ্ণুপ্রিয়া মণিপুরী (bpy): bpy
монгол (mn): mon
Runa Simi (qu): que
Diné bizaad (nv): nav
සිංහල (si): sin
მარგალური (xmf): xmf
Nordfriisk (frr): frr
پښتو (ps): pus
ирон (os): oss
chiTumbuka (tum): tum
ଓଡ଼ିଆ (or): ori
سنڌي (sd): snd
Bikol Central (bcl): bcl
žemaitėška (bat-smg): Unknown
саха тыла (sah): sah
閩東語 / Mìng-dĕ̤ng-ngṳ̄ (cdo): cdo
Gàidhlig (gd): gla
Basa Ugi (bug): bug
گیلکی (glk): glk
ייִדיש (yi): yid
Ilokano (ilo): ilo
አማርኛ (am): amh
Limburgs (li): lim
Napulitano (nap): nap
Bahasa Hulontalo (gor): gor
मैथिली (mai): mai
føroyskt (fo): fao
অসমীয়া (as): asm
hornjoserbsce (hsb): hsb
Basa Banyumasan (map-bms): Unknown
ၽႃႇသႃႇတႆး (shn): shn
文言 (zh-classical): Unknown
emiliàn e rumagnòl (eml): Unknown
Acèh (ace): ace
Interlingue (ie): ile
walon (wa): wln
संस्कृतम् (sa): san
Արեւմտահայերէն (hyw): hyw
ᱥᱟᱱᱛᱟᱲᱤ (sat): sat
isiZulu (zu): zul
chiShona (sn): sna
олык марий (mhr): mhr
Ligure (lij): lij
Fiji Hindi (hif): hif
Banjar (bjn): bjn
ភាសាខ្មែរ (km): khm
ꯃꯤꯇꯩ ꯂꯣꯟ (mni): mni
кырык мары (mrj): mrj
الدارجة (ary): ary
客家語 / Hak-kâ-ngî (hak): hak
dagbanli (dag): dag
Kapampangan (pam): pam
русиньскый (rue): rue
tarandíne (roa-tara): Unknown
भोजपुरी (bh): Unknown
Sesotho sa Leboa (nso): nso
corsu (co): cos
tolışi (tly): tly
Soomaaliga (so): som
West-Vlams (vls): vls
Māori (mi): mri
Nedersaksies (nds-nl): Unknown
davvisámegiella (se): sme
эрзянь (myv): myv
Ikinyarwanda (rw): kin
Qaraqalpaqsha (kaa): kaa
sardu (sc): srd
བོད་ཡིག (bo): bod
kernowek (kw): cor
vepsän kel’ (vep): vep
Malti (mt): mlt
Türkmençe (tk): tuk
Taqbaylit (kab): kab
Gaelg (gv): glv
ئۇيغۇرچە / Uyghurche (ug): uig
мокшень (mdf): mdf
贛語 (gan): gan
võro (fiu-vro): vro
Zeêuws (zea): zea
аԥсшәа (ab): abk
سرائیکی (skr): skr
anarâškielâ (smn): smn
Avañe'ẽ (gn): grn
कॉशुर / کٲشُر (ks): kas
arpetan (frp): frp
Picard (pcd): pcd
Fulfulde (ff): ful
удмурт (udm): udm
коми (kv): kom
kaszëbsczi (csb): csb
Aymar aru (ay): aym
Nouormand (nrm): nrm
Ænglisc (ang): ang
furlan (fur): fur
livvinkarjala (olo): olo
ລາວ (lo): lao
Lingua Franca Nova (lfn): lfn
лезги (lez): lez
Nāhuatl (nah): Unknown
Mirandés (mwl): mwl
Papiamentu (pap): pap
lingála (ln): lin
Twi (tw): twi
Seeltersk (stq): stq
rumantsch (rm): roh
estremeñu (ext): ext
Ladino (lad): lad
गोंयची कोंकणी / Gõychi Konknni (gom): gom
डोटेली (dty): dty
авар (av): ava
тыва дыл (tyv): tyv
перем коми (koi): koi
dolnoserbski (dsb): dsb
Luganda (lg): lug
Chavacano de Zamboanga (cbk-zam): Unknown
ދިވެހިބަސް (dv): div
Ripoarisch (ksh): ksh
Vahcuengh (za): zha
буряад (bxr): bxr
ပအိုဝ်ႏဘာႏသာႏ (blk): blk
Gagauz (gag): gag
ⵜⴰⵎⴰⵣⵉⵖⵜ ⵜⴰⵏⴰⵡⴰⵢⵜ (zgh): zgh
Pälzisch (pfl): pfl
Sakizaya (szy): szy
Betawi (bew): bew
Hawaiʻi (haw): haw
Tayal (tay): tay
Pangasinan (pag): pag
पालि (pi): pli
अवधी (awa): awa
ತುಳು (tcy): tcy
къарачай-малкъар (krc): krc
гӀалгӀай (inh): inh
isiXhosa (xh): xho
fɔ̀ngbè (fon): fon
Ghanaian Pidgin (gpe): gpe
Atikamekw (atj): atj
Kumoring (kge): kge
lea faka-Tonga (to): ton
Deitsch (pdc): pdc
ဘာသာမန် (mnw): mnw
ܐܪܡܝܐ (arc): arc
Taclḥit (shi): shi
Setswana (tn): tsn
Oromoo (om): orm
Gĩkũyũ (ki): kik
Dagaare (dga): dga
хальмг (xal): xal
Li Niha (nia): nia
Patois (jam): jam
Kabɩyɛ (kbp): kbp
Wolof (wo): wol
Novial (nov): nov
адыгэбзэ (kbd): kbd
अंगिका (anp): anp
ߒߞߏ (nqo): nqo
Bislama (bi): bis
armãneashti (roa-rup): Unknown
Tok Pisin (tpi): tpi
Kongo (kg): kon
tetun (tet): tet
gungbe (guw): guw
la .lojban. (jbo): jbo
Madhurâ (mad): mad
Na Vosa Vakaviti (fj): fij
лакку (lbe): lbe
Tyap (kcg): kcg
словѣньскъ / ⰔⰎⰑⰂⰡⰐⰠⰔⰍⰟ (cu): chu
Naijá (pcm): pcm
reo tahiti (ty): tah
Seediq (trv): trv
Gagana Samoa (sm): smo
Pangcah (ami): ami
Kadazandusun (dtp): dtp
Sranantongo (srn): srn
Batak Mandailing (btm): btm
алтай тил (alt): alt
latgaļu (ltg): ltg
kriyòl gwiyannen (gcr): gcr
Chi-Chewa (ny): nya
Sesotho (st): sot
Jaku Iban (iba): iba
Kʋsaal (kus): kus
ᏣᎳᎩ (chr): chr
SiSwati (ss): ssw
eʋegbe (ee): ewe
moore (mos): mos
Xitsonga (ts): tso
farefare (gur): gur
𐌲𐌿𐍄𐌹𐍃𐌺 (got): got
bamanankan (bm): bam
Batak Toba (bbc): bbc
Norfuk / Pitkern (pih): pih
Tshivenda (ve): ven
romani čhib (rmy): rmy
mfantse (fat): fat
Tsetsêhestâhese (chy): chy
ikirundi (rn): run
Igala (igl): igl
Iñupiatun (ik): ipk
wayuunaiki (guc): guc
адыгабзэ (ady): ady
Chamoru (ch): cha
Ποντιακά (pnt): pnt
ᐃᓄᒃᑎᑐᑦ / inuktitut (iu): iku
Obolo (ann): ann
pinayuanan (pwn): pwn
руски (rsk): rsk
Thuɔŋjäŋ (din): din
Sängö (sg): sag
ཇོང་ཁ (dz): dzo
ትግርኛ (ti): tir
ᥖᥭᥰ ᥖᥬᥲ ᥑᥨᥒᥰ (tdd): tdd
kalaallisut (kl): kal
Bajau Sama (bdr): bdr
isiNdebele seSewula (nr): nbl
Nēhiyawēwin / ᓀᐦᐃᔭᐍᐏᐣ (cr): cre
