English (en): eng
Cebuano (ceb): ceb
Deutsch (de): deu
français (fr): fra
svenska (sv): swe
Nederlands (nl): nld
русский (ru): rus
español (es): spa
italiano (it): ita
polski (pl): pol
مصرى (arz): arz
中文 (zh): zho
日本語 (ja): jpn
українська (uk): ukr
Tiếng Việt (vi): vie
العربية (ar): ara
Winaray (war): war
português (pt): por
فارسی (fa): fas
català (ca): cat
Bahasa Indonesia (id): ind
한국어 (ko): kor
српски / srpski (sr): srp
norsk (no): nor
Türkçe (tr): tur
suomi (fi): fin
нохчийн (ce): che
čeština (cs): ces
magyar (hu): hun
română (ro): ron
татарча / tatarça (tt): tat
euskara (eu): eus
srpskohrvatski / српскохрватски (sh): hbs
閩南語 / Bân-lâm-gí (zh-min-nan): Unknown
Bahasa Melayu (ms): msa
עברית (he): heb
Esperanto (eo): epo
հայերեն (hy): hye
dansk (da): dan
oʻzbekcha / ўзбекча (uz): uzb
български (bg): bul
Cymraeg (cy): cym
Simple English (simple): Unknown
Ελληνικά (el): ell
беларуская (be): bel
slovenčina (sk): slk
eesti (et): est
تۆرکجه (azb): azb
қазақша (kk): kaz
اردو (ur): urd
Minangkabau (min): min
hrvatski (hr): hrv
galego (gl): glg
lietuvių (lt): lit
azərbaycanca (az): aze
slovenščina (sl): slv
ქართული (ka): kat
Ladin (lld): lld
தமிழ் (ta): tam
ไทย (th): tha
বাংলা (bn): ben
norsk nynorsk (nn): nno
हिन्दी (hi): hin
македонски (mk): mkd
粵語 (zh-yue): Unknown
Latina (la): lat
latviešu (lv): lav
asturianu (ast): ast
Afrikaans (af): afr
తెలుగు (te): tel
тоҷикӣ (tg): tgk
မြန်မာဘာသာ (my): mya
shqip (sq): sqi
Kiswahili (sw): swa
Malagasy (mg): mlg
मराठी (mr): mar
bosanski (bs): bos
kurdî (ku): kur
occitan (oc): oci
беларуская (тарашкевіца) (be-tarask): Unknown
brezhoneg (br): bre
മലയാളം (ml): mal
Plattdüütsch (nds): nds
lombard (lmo): lmo
کوردی (ckb): ckb
кыргызча (ky): kir
Jawa (jv): jav
پنجابی (pnb): pnb
नेपाल भाषा (new): new
Kreyòl ayisyen (ht): hat
Piemontèis (pms): pms
Hausa (ha): hau
vèneto (vec): vec
Lëtzebuergesch (lb): ltz
مازِرونی (mzn): mzn
башҡортса (ba): bak
Gaeilge (ga): gle
Sunda (su): sun
íslenska (is): isl
Ido (io): ido
ślůnski (szl): szl
ਪੰਜਾਬੀ (pa): pan
Frysk (fy): fry
чӑвашла (cv): chv
aragonés (an): arg
Tagalog (tl): tgl
گیلکی (glk): glk
吴语 (wuu): wuu
Volapük (vo): vol
Igbo (ig): ibo
Zazaki (diq): diq
Yorùbá (yo): yor
Scots (sco): sco
ಕನ್ನಡ (kn): kan
Basa Bali (ban): ban
Alemannisch (als): als
ગુજરાતી (gu): guj
interlingua (ia): ina
Kotava (avk): avk
qırımtatarca (crh): crh
नेपाली (ne): nep
Boarisch (bar): bar
монгол (mn): mon
sicilianu (scn): scn
বিষ্ণুপ্রিয়া মণিপুরী (bpy): bpy
සිංහල (si): sin
سرائیکی (skr): skr
Runa Simi (qu): que
Diné bizaad (nv): nav
მარგალური (xmf): xmf
ирон (os): oss
Bikol Central (bcl): bcl
پښتو (ps): pus
Nordfriisk (frr): frr
ଓଡ଼ିଆ (or): ori
অসমীয়া (as): asm
سنڌي (sd): snd
chiTumbuka (tum): tum
саха тыла (sah): sah
žemaitėška (bat-smg): Unknown
閩東語 / Mìng-dĕ̤ng-ngṳ̄ (cdo): cdo
Gàidhlig (gd): gla
Basa Ugi (bug): bug
ייִדיש (yi): yid
አማርኛ (am): amh
Ilokano (ilo): ilo
Limburgs (li): lim
Napulitano (nap): nap
Bahasa Hulontalo (gor): gor
मैथिली (mai): mai
føroyskt (fo): fao
hornjoserbsce (hsb): hsb
တႆး (shn): shn
Basa Banyumasan (map-bms): Unknown
文言 (zh-classical): Unknown
ᱥᱟᱱᱛᱟᱲᱤ (sat): sat
emiliàn e rumagnòl (eml): Unknown
Interlingue (ie): ile
dagbanli (dag): dag
Արեւմտահայերէն (hyw): hyw
Acèh (ace): ace
walon (wa): wln
संस्कृतम् (sa): san
Fiji Hindi (hif): hif
ⵜⴰⵎⴰⵣⵉⵖⵜ ⵜⴰⵏⴰⵡⴰⵢⵜ (zgh): zgh
isiZulu (zu): zul
Fulfulde (ff): ful
ភាសាខ្មែរ (km): khm
chiShona (sn): sna
Ligure (lij): lij
Banjar (bjn): bjn
олык марий (mhr): mhr
Taclḥit (shi): shi
الدارجة (ary): ary
Qaraqalpaqsha (kaa): kaa
ꯃꯤꯇꯩ ꯂꯣꯟ (mni): mni
кырык мары (mrj): mrj
客家語 / Hak-kâ-ngî (hak): hak
Kapampangan (pam): pam
русиньскый (rue): rue
tolışi (tly): tly
ئۇيغۇرچە / Uyghurche (ug): uig
tarandíne (roa-tara): Unknown
भोजपुरी (bh): Unknown
Sesotho sa Leboa (nso): nso
corsu (co): cos
Soomaaliga (so): som
Ikinyarwanda (rw): kin
West-Vlams (vls): vls
Nedersaksies (nds-nl): Unknown
Māori (mi): mri
davvisámegiella (se): sme
эрзянь (myv): myv
کٲشُر (ks): kas
sardu (sc): srd
мокшень (mdf): mdf
Malti (mt): mlt
བོད་ཡིག (bo): bod
kernowek (kw): cor
vepsän kel’ (vep): vep
Zeêuws (zea): zea
Taqbaylit (kab): kab
Türkmençe (tk): tuk
Gaelg (gv): glv
võro (fiu-vro): vro
贛語 (gan): gan
аԥсшәа (ab): abk
anarâškielâ (smn): smn
Picard (pcd): pcd
Avañe'ẽ (gn): grn
arpetan (frp): frp
коми (kv): kom
удмурт (udm): udm
kaszëbsczi (csb): csb
ລາວ (lo): lao
Aymar aru (ay): aym
Nouormand (nrm): nrm
Ænglisc (ang): ang
Papiamentu (pap): pap
furlan (fur): fur
lingála (ln): lin
Twi (tw): twi
livvinkarjala (olo): olo
Lingua Franca Nova (lfn): lfn
лезги (lez): lez
Nāhuatl (nah): Unknown
Mirandés (mwl): mwl
Seeltersk (stq): stq
Luganda (lg): lug
estremeñu (ext): ext
тыва дыл (tyv): tyv
Ladino (lad): lad
rumantsch (rm): roh
Ghanaian Pidgin (gpe): gpe
авар (av): ava
गोंयची कोंकणी / Gõychi Konknni (gom): gom
डोटेली (dty): dty
перем коми (koi): koi
dolnoserbski (dsb): dsb
Chavacano de Zamboanga (cbk-zam): Unknown
fɔ̀ngbè (fon): fon
ދިވެހިބަސް (dv): div
Ripoarisch (ksh): ksh
Betawi (bew): bew
Gagauz (gag): gag
Vahcuengh (za): zha
Hawaiʻi (haw): haw
ပအိုဝ်ႏဘာႏသာႏ (blk): blk
буряад (bxr): bxr
Pälzisch (pfl): pfl
ತುಳು (tcy): tcy
Sakizaya (szy): szy
Kumoring (kge): kge
Pangasinan (pag): pag
къарачай-малкъар (krc): krc
Tayal (tay): tay
Dagaare (dga): dga
पालि (pi): pli
अवधी (awa): awa
Setswana (tn): tsn
гӀалгӀай (inh): inh
isiXhosa (xh): xho
Atikamekw (atj): atj
Deitsch (pdc): pdc
lea faka-Tonga (to): ton
Oromoo (om): orm
ဘာသာမန် (mnw): mnw
Madhurâ (mad): mad
ܐܪܡܝܐ (arc): arc
Gĩkũyũ (ki): kik
Novial (nov): nov
Li Niha (nia): nia
Jaku Iban (iba): iba
Wolof (wo): wol
Patois (jam): jam
Kabɩyɛ (kbp): kbp
Kadazandusun (dtp): dtp
अंगिका (anp): anp
адыгэбзэ (kbd): kbd
хальмг (xal): xal
Na Vosa Vakaviti (fj): fij
Kongo (kg): kon
ߒߞߏ (nqo): nqo
gungbe (guw): guw
Tok Pisin (tpi): tpi
Naijá (pcm): pcm
Sesotho (st): sot
Bislama (bi): bis
Yerwa Kanuri (knc): knc
Tyap (kcg): kcg
armãneashti (roa-rup): Unknown
tetun (tet): tet
la .lojban. (jbo): jbo
словѣньскъ / ⰔⰎⰑⰂⰡⰐⰠⰔⰍⰟ (cu): chu
moore (mos): mos
eʋegbe (ee): ewe
лакку (lbe): lbe
reo tahiti (ty): tah
Seediq (trv): trv
ꠍꠤꠟꠐꠤ (syl): syl
Kʋsaal (kus): kus
Batak Toba (bbc): bbc
Batak Mandailing (btm): btm
Gagana Samoa (sm): smo
farefare (gur): gur
Pangcah (ami): ami
Sranantongo (srn): srn
SiSwati (ss): ssw
mfantse (fat): fat
алтай тил (alt): alt
latgaļu (ltg): ltg
Chi-Chewa (ny): nya
kriyòl gwiyannen (gcr): gcr
ᏣᎳᎩ (chr): chr
ရခိုင် (rki): rki
𐌲𐌿𐍄𐌹𐍃𐌺 (got): got
Xitsonga (ts): tso
Igala (igl): igl
bamanankan (bm): bam
руски (rsk): rsk
Tshivenda (ve): ven
romani čhib (rmy): rmy
Tsetsêhestâhese (chy): chy
ikirundi (rn): run
wayuunaiki (guc): guc
Iñupiatun (ik): ipk
адыгабзэ (ady): ady
Chamoru (ch): cha
Ποντιακά (pnt): pnt
Nupe (nup): nup
Obolo (ann): ann
ᐃᓄᒃᑎᑐᑦ / inuktitut (iu): iku
pinayuanan (pwn): pwn
Sängö (sg): sag
ཇོང་ཁ (dz): dzo
ᥖᥭᥰ ᥖᥬᥲ ᥑᥨᥒᥰ (tdd): tdd
Thuɔŋjäŋ (din): din
ትግርኛ (ti): tir
isiNdebele seSewula (nr): nbl
kalaallisut (kl): kal
Bajau Sama (bdr): bdr
ትግሬ (tig): tig
Nēhiyawēwin / ᓀᐦᐃᔭᐍᐏᐣ (cr): cre
